05,05
00,00
2,2,3,3,2
9,9,0,3,9
D,E,2,3,9
9,9,9,3,1
1,1,1,3,0
