08,08
07,07
3,6,C,3,7,C,A,4
D,5,B,9,D,8,9,7
9,8,D,5,9,5,5,A
4,6,8,A,2,9,1,A
5,E,C,4,6,6,8,6
9,3,4,3,A,7,B,7
5,A,D,6,E,5,1,A
2,9,D,1,7,A,6,4
