08,08
00,00
3,9,7,2,E,7,7,3
2,6,7,1,9,A,A,2
7,F,8,9,A,1,B,8
3,A,7,F,D,9,7,3
A,9,1,9,C,8,5,5
6,F,C,E,7,E,F,5
7,5,4,9,1,6,2,A
8,A,3,6,3,2,A,5
