08,08
07,07
2,5,B,1,7,E,A,3
B,7,D,9,C,6,9,5
A,7,E,8,A,7,7,9
2,7,8,A,4,9,2,9
7,D,7,4,5,7,6,6
9,1,3,3,9,7,E,5
6,9,C,5,E,3,3,A
4,9,C,1,8,A,8,1
