08,08
03,05
6,7,2,4,7,5,B,7
4,A,6,6,D,C,9,9
8,5,8,F,5,1,9,1
9,2,6,9,8,9,F,5
A,8,D,B,5,6,9,4
A,A,9,4,6,6,7,7
8,B,6,5,4,1,4,9
2,5,4,D,A,8,8,5
