06,06
00,00
1,7,C,9,1,3
A,9,9,7,A,5
6,B,5,F,D,1
4,A,1,6,B,8
9,1,8,B,6,9
8,A,5,1,4,5
