05,05
01,01
5,E,A,7,2
A,4,6,D,6
5,2,7,E,8
7,7,6,7,A
4,6,6,4,5
