06,06
02,05
7,A,6,5,2,2
9,2,5,F,8,9
9,D,9,C,5,8
A,8,2,4,6,7
6,E,9,B,D,1
4,6,2,D,6,1
