10,10
06,07
3,D,A,9,B,3,1,9,9,7
5,5,3,A,8,5,2,8,5,9
C,5,7,5,2,A,5,6,9,9
9,8,7,A,E,7,9,4,6,9
9,8,A,6,5,9,F,8,5,B
9,9,6,9,A,A,B,6,5,2
9,9,A,5,4,6,8,7,A,8
9,1,6,8,2,A,3,2,6,B
9,6,5,7,F,5,B,A,B,A
6,7,7,6,7,A,8,3,5,2
