06,06
05,05
2,8,4,8,7,7
6,B,8,6,8,A
A,8,C,9,7,A
1,5,6,5,F,8
5,9,6,9,7,8
1,2,9,D,1,4
