10,10
00,00
4,B,9,7,4,5,4,7,6,7
6,5,3,7,9,F,8,D,8,1
A,6,8,5,A,8,9,8,A,5
D,6,3,9,3,9,8,6,B,5
D,5,D,8,2,D,8,9,9,1
4,9,8,9,A,7,E,8,8,E
6,8,7,A,A,8,8,9,2,1
8,B,7,8,7,A,8,9,D,1
3,A,4,9,B,5,9,3,F,1
8,5,8,8,6,9,8,4,D,3
