07,07
02,04
1,7,A,7,4,7,6
9,9,8,C,D,D,4
7,C,3,2,1,E,4
2,9,7,C,6,D,7
6,C,1,5,C,A,D
4,8,3,6,6,4,9
6,A,A,B,9,7,1
