09,09
00,00
1,2,9,A,9,8,3,C,6
9,6,A,9,9,7,7,6,A
7,F,9,9,8,6,5,4,9
5,F,B,3,A,C,A,C,1
2,4,9,1,C,2,6,F,7
1,6,B,5,7,6,C,3,A
9,1,9,5,A,D,3,3,9
9,6,8,8,6,2,3,A,A
6,C,A,6,7,A,8,7,8
