11,11
00,00
2,5,8,9,9,8,8,7,7,6,1
8,D,7,8,1,7,2,A,3,9,A
9,3,2,D,8,8,A,7,8,6,A
5,9,D,1,9,8,7,7,6,2,9
6,A,F,A,8,8,D,7,5,B,A
8,6,6,9,9,B,5,9,8,9,A
4,6,3,6,7,D,7,1,9,6,9
9,8,9,5,A,1,3,6,1,8,5
9,5,2,8,C,3,6,D,6,D,4
A,7,A,7,9,E,8,A,5,D,A
8,D,9,4,8,8,2,D,7,8,5
