06,06
00,00
2,5,4,C,9,7
3,D,9,D,6,6
7,C,3,A,7,3
2,9,5,E,6,2
E,E,A,8,7,C
8,9,1,6,1,1
