06,06
00,00
2,C,9,7,2,2
6,7,5,B,9,9
2,1,9,C,6,A
6,F,6,8,5,A
A,8,A,1,9,9
8,9,3,2,C,8
