08,08
07,00
4,8,A,B,A,9,5,4
A,A,1,9,1,8,B,7
8,5,E,6,8,B,7,5
6,9,B,2,9,7,4,1
5,8,1,C,F,9,9,3
2,F,3,2,A,5,9,1
2,9,2,E,B,F,8,3
8,C,A,8,3,8,5,7
