12,12
08,05
2,6,9,9,8,6,A,9,D,5,6,8
9,9,5,7,8,6,6,3,A,A,A,9
7,F,5,6,9,A,F,A,5,9,9,1
6,5,6,9,A,6,A,1,5,6,8,5
A,5,6,8,A,5,A,9,9,7,8,A
9,9,2,6,5,A,6,9,3,A,A,A
9,7,6,8,F,A,9,5,1,9,5,6
8,9,6,A,9,5,9,A,6,5,9,5
7,9,9,8,8,8,7,5,4,9,7,A
9,8,8,8,8,6,5,9,3,7,9,A
A,A,9,A,9,9,6,6,6,F,8,9
5,7,8,6,7,6,5,A,6,6,A,8
