06,06
04,03
3,B,9,4,4,7
D,5,5,7,6,5
B,9,C,1,C,7
A,1,A,2,3,A
9,9,6,F,B,5
1,8,9,8,8,3
