07,07
00,00
3,5,B,3,2,6,7
8,E,A,2,5,C,1
5,7,5,D,3,8,5
9,8,9,6,9,7,5
9,5,2,2,E,F,5
A,8,9,9,9,6,9
1,5,3,3,A,9,5
