10,10
04,05
6,7,6,9,3,4,9,E,9,3
1,9,7,7,5,A,6,5,8,6
4,B,6,F,8,1,1,7,B,A
6,5,A,7,7,9,4,A,5,9
A,3,7,7,D,6,5,1,7,5
D,9,6,A,4,1,A,6,D,7
9,2,C,6,8,C,8,5,7,E
B,D,8,A,8,F,7,B,8,1
4,9,7,A,A,D,E,7,7,7
4,5,1,2,A,7,6,A,8,1
