11,11
03,03
5,9,9,3,3,3,6,6,9,9,5
A,5,E,2,D,5,5,E,5,8,A
E,8,1,6,6,9,8,6,A,7,5
7,9,7,3,4,A,9,4,D,A,1
3,6,C,3,C,7,9,A,A,7,6
6,5,B,9,6,6,E,7,6,9,9
7,8,7,B,9,C,4,6,8,A,3
3,9,6,5,1,9,5,5,9,6,6
A,B,5,3,F,5,A,2,9,3,C
8,5,4,A,F,A,6,D,7,1,9
4,A,A,A,C,9,4,5,9,C,8
