10,10
00,00
2,7,9,7,2,6,7,4,B,5
8,C,6,8,7,E,A,6,5,9
6,8,6,3,6,8,7,C,1,9
9,7,A,7,A,1,1,6,5,9
9,8,5,9,E,D,6,8,8,6
8,B,8,8,8,B,E,7,2,7
6,C,4,5,5,6,9,2,6,5
A,7,9,6,A,3,B,5,D,8
9,8,A,2,C,8,9,7,E,A
6,5,2,9,6,2,5,2,5,4
