10,10
00,00
4,5,9,9,6,4,5,A,A,5
8,C,2,1,9,6,F,7,4,8
6,6,A,6,8,6,5,8,7,3
5,B,8,7,6,7,8,4,B,C
6,D,6,5,8,6,B,5,4,9
3,5,6,4,5,E,A,1,B,C
7,9,2,6,8,8,6,7,8,9
9,1,C,A,1,7,6,A,3,A
A,7,E,5,A,7,6,8,B,7
5,6,7,B,A,9,2,4,E,1
