09,09
00,00
2,7,9,7,7,B,9,9,8
8,B,4,9,1,A,7,3,1
4,A,7,6,8,5,E,A,6
7,F,A,8,A,2,B,1,9
6,6,2,E,B,5,A,8,9
A,6,4,2,9,3,3,9,A
A,9,2,F,7,6,E,6,E
6,B,2,D,A,5,B,6,9
4,8,5,7,4,A,7,6,6
