08,08
03,00
7,E,1,4,3,B,9,7
A,7,5,A,8,5,2,9
4,4,A,9,6,9,B,A
2,7,F,E,2,1,D,4
8,6,8,9,E,5,8,5
2,D,9,C,7,9,5,5
7,4,5,D,7,8,D,7
8,9,8,2,8,9,6,1
