10,10
06,07
4,5,7,5,7,A,E,A,E,3
2,F,6,8,F,4,A,1,1,2
2,6,9,1,5,7,D,8,6,5
6,7,3,1,3,A,8,9,6,2
6,F,8,6,F,B,6,8,6,8
1,7,9,A,6,6,7,5,F,1
2,7,9,C,6,3,2,A,F,8
A,D,7,4,A,9,4,8,A,1
D,5,1,1,7,B,E,7,F,5
6,9,A,9,9,8,6,A,6,1
