05,05
00,00
2,8,4,C,7
5,E,9,C,1
B,8,2,A,4
A,8,5,7,D
7,A,9,1,4
