12,12
04,05
6,9,9,8,7,7,8,A,7,7,5,A
A,7,2,A,A,A,C,2,9,9,9,A
6,6,8,F,7,9,A,1,9,A,A,A
7,7,9,A,6,8,7,6,9,9,9,9
9,6,7,3,A,2,A,A,B,A,A,A
A,6,8,5,F,9,A,9,8,A,A,9
5,5,9,9,9,5,A,6,8,5,9,9
7,A,7,9,9,9,8,6,7,5,A,9
4,8,A,8,9,9,9,6,A,E,A,A
5,5,8,6,4,A,5,D,5,6,A,A
9,5,8,A,7,8,6,5,5,5,A,A
6,5,4,C,8,1,5,1,A,7,6,8
