08,08
00,00
1,6,7,9,D,1,8,2
5,F,B,5,D,2,F,4
A,A,1,1,3,8,6,1
9,5,9,8,5,D,7,8
8,9,2,C,7,6,8,1
6,9,9,F,9,9,B,6
8,B,6,8,A,7,7,8
2,8,5,9,4,2,4,5
