05,17
00,04
6,A,7,0,2,0,6,A,7,0,6,A,3,0,6,A,3
9,0,9,0,9,0,9,0,9,0,9,0,0,0,9,0,0
D,A,5,0,9,0,D,A,5,0,D,A,3,0,8,A,7
9,0,0,0,9,0,9,0,0,0,9,0,0,0,0,0,9
1,0,0,0,1,0,1,0,0,0,8,A,3,0,4,A,5
