05,05
02,02
2,0,6,A,3
9,0,9,0,0
8,A,F,A,7
0,0,9,0,9
4,A,5,0,1
